IMU	KEYWORD1

IMU_6DOF	KEYWORD1

IMU_PI	KEYWORD2
RAD2ANG	KEYWORD2
ANG2RAD	KEYWORD2
SampleFreq	KEYWORD2
Ki	KEYWORD2
Kp	KEYWORD2
BETA	KEYWORD2

MAHONY	KEYWORD1
MADGWICK	KEYWORD1
EKF	KEYWORD1
UKF	KEYWORD1

getData	KEYWORD2
getAccelData	KEYWORD2
getGyroData	KEYWORD2
accelCalibrate	KEYWORD2
gyroCalibrate	KEYWORD2
fromQuaternion2RPY	KEYWORD2/
changeParam	KEYWORD2
updateAccelOffset	KEYWORD2
updateGyroOffset	KEYWORD2
updateState	KEYWORD2

accel	KEYWORD2
gyro	KEYWORD2
q	KEYWORD2
euler	KEYWORD2
roll	KEYWORD2
pitch	KEYWORD2
yaw	KEYWORD2
sample_freq	KEYWORD2